.....#..#...
....#..@..##
#..#..#.....
.#.#...#.###
....###...##
.###.#....#.
.##.##.#....
.#....#.##..
###....#...#
.......#..##
