###...###
#.......#
#..#....#
......#..
....@....
...#.....
#.......#
#.......#
###...###