#...##.#....
#...#.....#.
.#..#...#.##
###.........
.#.#.#......
@...#.....#.
#.#.#.....##
.#..........
.#..#.......
..#.........
